5,5
S,.,.,.,.
.,.,.,.,.
.,.,.,.,.
.,.,.,.,.
.,.,X,.,.
